ALPHABET -> a | b | c | d | e | f | g | h | i | j | k | l | m | n | o | p | q | r | s | t | u | v | w | x | y | z | A | B | C | D | E | F | G | H | I | J | K | L | M | N | O | P | Q | R | S | T | U | V | W | X | Y | Z;
DIGIT -> 0 | 1 | 2 | 3 | 4 | 5 | 6 | 7 | 8 | 9;
NONZERO -> 1 | 2 | 3 | 4 | 5 | 6 | 7 | 8 | 9;
OTHER ->  ATS | ZERO | DOTS | XORS | ANDS | ORS | SERU | QUEST | HASHTAG | DOLLAR | PERSEN | NBO | NBC | WAVE | MUL | POW | PLUS | MIN | INCR | DECR | COMMA | DIVBACK | DIVIDE | DIV | COLON | SEMICOLON | LESS | EQUAL | GREAT | SBO | SBC | UNDERSCORE | CBO | CBC | PETIK1 | PETIK2 | DELETES | SWITCHES | CASES | VOIDS | TYPEOFS | ANDS | TRYS | ISS | INS | NOTS | TRUES | FALSES | FORS | DOS | WHILES | IFS | ELSES | BREAKS | CONTINUES | FINALLYS | CATCHS | FUNCTIONS | RETURNS | CLASSS | FROMS | IMPORTS | ASS | VAR | EXPORTS | EXTENDSS | CONSTS | SUPERS | WITHS | YIELDS | DEFAULTS | THROWS | STATICS | TARGETS | NEWS | THISS | NULLS | INSTANCEOFS | SEMICOLON | ;

COMMENT -> MULTILINECOMMENT | SINGLELINECOMMENT;
MULTILINECOMMENT -> DIVIDE MUL MULTILINECOMMENTCHARS MUL DIVIDE | DIVIDE MUL MUL DIVIDE;
MULTILINECOMMENTCHARS -> MULTILINENOTASTERISKCHAR MULTILINECOMMENTCHARS | MULTILINENOTASTERISKCHAR | MUL POSTASTERISKCOMMENTCHARS | MUL;
POSTASTERISKCOMMENTCHARS -> MULTILINENOTFORWARDSLASHORASTERISKCHAR MULTILINECOMMENTCHARS | MULTILINENOTFORWARDSLASHORASTERISKCHAR | MUL POSTASTERISKCOMMENTCHARS | MUL;
MULTILINENOTASTERISKCHAR -> ALPHABET | DIGIT | $ | & | . | ? | @ | \ | ^ | ` | ~ | SERU | HASHTAG | PERSEN | NBO | NBC | PLUS | MIN | COMMA | DIVIDE | COLON | SEMICOLON | LESS | EQUAL | GREAT | SBO | SBC | UNDERSCORE | CBO | CBC | |;
MULTILINENOTFORWARDSLASHORASTERISKCHAR -> ALPHABET | DIGIT | $ | & | . | ? | @ | \ | ^ | ` | ~ | SERU | HASHTAG | PERSEN | NBO | NBC | PLUS | MIN | COMMA | COLON | SEMICOLON | LESS | EQUAL | GREAT | SBO | SBC | UNDERSCORE | CBO | CBC | |;
SINGLELINECOMMENT -> DIV SINGLELINECOMMENTCHARS;
SINGLELINECOMMENTCHARS -> SINGLELINECOMMENTCHAR | SINGLELINECOMMENTCHAR SINGLELINECOMMENTCHARS;
SINGLELINECOMMENTCHAR -> ALPHABET | DIGIT | OTHER;
IDENTIFIERNAME -> IDENTIFIERSTART | IDENTIFIERNAME IDENTIFIERPART;
IDENTIFIERSTART -> DOLLAR | UNDERSCORE | DIVBACK;
IDENTIFIERPART -> IDENTIFIERSTART | DIGIT | ALPHABET | RESERVEDWORD;
IDENTIFIERPARTWITHOUTRESERVED -> IDENTIFIERSTART | DIGIT | ALPHABET;
RESERVEDWORD -> KEYWORD | NULLLITERAL | BOOLEANLITERAL;
KEYWORD -> BREAKS | DOS | INS | TYPEOFS | CLASSS | ELSES | INSTANCEOFS | VAR | CATCHS | EXPORTS | NEWS | VOIDS | EXTENDSS | RETURNS | WHILES | CONSTS | FINALLYS | SUPERS | WITHS | CONTINUES | FORS | SWITCHS | YIELDS | FUNCTIONS | THIS | DEFAULTS | IFS | THROWS | DELETES | IMPORTS | TRYS;
NULLLITERAL -> NULLS;
BOOLEANLITERAL -> TRUES | FALSES;
NUMERICLITERAL -> DECIMALLITERAL | BINARYINTEGERLITERAL | OCTALINTEGERLITERAL | HEXINTEGERLITERAL;
DECIMALLITERAL -> DECIMALINTEGERLITERAL DOTS | DECIMALINTEGERLITERAL DOTS DECIMALDIGITS | DECIMALINTEGERLITERAL DOTS EXPONENTPART | DECIMALINTEGERLITERAL DOTS DECIMALDIGITS EXPONENTPART | DOTS DECIMALDIGITS | DOTS DECIMALDIGITS EXPONENTPART | DECIMALINTEGERLITERAL EXPONENTPART | DECIMALINTEGERLITERAL;
DECIMALINTEGERLITERAL -> ZERO | NONZERO DECIMALDIGITS | NONZERO;
DECIMALDIGITS -> DECIMALDIGITS DIGIT | DIGIT;
NONZERO -> 1 | 2 | 3 | 4 | 5 | 6 | 7 | 8 | 9;
EXPONENTPART -> EXPONENTINDICATOR SIGNEDINTEGER;
EXPONENTINDICATOR -> E | e;
SIGNEDINTEGER -> SIGN DECIMALDIGITS | DECIMALDIGITS;
SIGN -> PLUS | MIN;
PREBINARYDIGITS -> 0b | 0B;
BINARYINTEGERLITERAL -> PREBINARYDIGITS BINARYDIGITS;
BINARYDIGITS -> BINARYDIGITS BINARYDIGIT | BINARYDIGIT;
BINARYDIGIT -> 0 | 1;
PREOCTALDIGITS -> 0o | 0O;
OCTALINTEGERLITERAL -> PREOCTALDIGITS OCTALDIGITS;
OCTALDIGITS -> OCTALDIGITS OCTALDIGIT | OCTALDIGIT;
OCTALDIGIT -> 0 | 1 | 2 | 3 | 4 | 5 | 6 | 7;
PREHEXDIGITS -> 0x | 0X;
HEXINTEGERLITERAL -> PREHEXDIGITS HEXDIGITS;
HEXDIGITS -> HEXDIGITS HEXDIGIT | HEXDIGIT;
HEXDIGIT -> DIGIT | A | B | C | D | E | F | a | b | c | d | e | f; 
STRINGLITERAL -> PETIK2 DOUBLESTRINGCHARACTERS PETIK2 | PETIK1 SINGLESTRINGCHARACTERS PETIK1 | PETIK2 PETIK2 | PETIK1 PETIK1;
DOUBLESTRINGCHARACTERS -> DOUBLESTRINGCHARACTER | DOUBLESTRINGCHARACTER DOUBLESTRINGCHARACTERS;
SINGLESTRINGCHARACTERS -> SINGLESTRINGCHARACTER | SINGLESTRINGCHARACTER SINGLESTRINGCHARACTERS;
DOUBLESTRINGCHARACTER -> ALPHABET | DIGIT | $ | & | . | ? | @ | ^ | ` | ~ | MUL | SERU | HASHTAG | PERSEN | NBO | NBC | PLUS | MIN | COMMA | COLON | SEMICOLON | LESS | EQUAL | GREAT | SBO | SBC | UNDERSCORE | CBO | CBC | PETIK1 | | DIVIDE ESCAPESEQUENCE | LINECONTINUATION;
SINGLESTRINGCHARACTER -> ALPHABET | DIGIT | $ | & | . | ? | @ | ^ | ` | ~ | MUL | SERU | HASHTAG | PERSEN | NBO | NBC | PLUS | MIN | COMMA | COLON | SEMICOLON | LESS | EQUAL | GREAT | SBO | SBC | UNDERSCORE | CBO | CBC | PETIK2 | | DIVIDE ESCAPESEQUENCE | LINECONTINUATION;
ESCAPESEQUENCE -> CHARACTERESCAPESEQUENCE | ZERO | HEXESCAPESEQUENCE | UNICODEESCAPESEQUENCE;
CHARACTERESCAPESEQUENCE -> SINGLEESCAPECHARACTER | NONESCAPECHARACTER;
SINGLEESCAPECHARACTER -> PETIK1 | PETIK2 | DIVBACK | b | f | n | r | t | v;
NONESCAPECHARACTER -> a | c | d | e | g | h | i | j | k | l | m | o | p | q | s | w | y | z | A | B | C | D | E | F | G | H | I | J | K | L | M | N | O | P | Q | R | S | T | U | V | W | X | Y | Z | DIGIT | $ | & | . | ? | @ | ^ | ` | ~ | MUL | SERU | HASHTAG | PERSEN | NBO | NBC | PLUS | MIN | COMMA | COLON | SEMICOLON | LESS | EQUAL | GREAT | SBO | SBC | UNDERSCORE | CBO | CBC | DIVIDE ESCAPESEQUENCE | LINECONTINUATION ;  
ESCAPECHARACTER -> SINGLEESCAPECHARACTER | DECIMALDIGITS | x | u;
HEXESCAPESEQUENCE -> x HEXDIGIT HEXDIGIT;
UNICODEESCAPESEQUENCE -> u HEX4DIGITS | u CBO HEXDIGITS CBC; 
HEX4DIGITS -> HEXDIGIT HEXDIGIT HEXDIGIT HEXDIGIT;
TEMPLATE -> NOSUBSTITUTIONTEMPLATE | TEMPLATEHEAD;
NOSUBSTITUTIONTEMPLATE -> PETIK1 TEMPLATECHARACTERS PETIK1 | PETIK1 PETIK1;
TEMPLATEHEAD -> PETIK1 TEMPLATECHARACTERS DOLLAR CBO | PETIK1 DOLLAR CBO;
TEMPLATESUBSTITUTIONTAIL -> TEMPLATEMIDDLE | TEMPLATETAIL;
TEMPLATEMIDDLE -> CBC TEMPLATECHARACTERS DOLLAR CBO | PETIK1 DOLLAR CBO;
TEMPLATETAIL -> CBC TEMPLATECHARACTERS PETIK1 | CBC PETIK1;
TEMPLATECHARACTERS -> TEMPLATECHARACTER | TEMPLATECHARACTER TEMPLATECHARACTERS;
TEMPLATECHARACTER -> ALPHABET | DIGIT | & | . | ? | @ | ^ | ~ | MUL | SERU | HASHTAG | PERSEN | NBO | NBC | PLUS | MIN | COMMA | COLON | SEMICOLON | LESS | EQUAL | GREAT | SBO | SBC | UNDERSCORE | CBO | CBC | PETIK2 | | LINECONTINUATION | DIVIDE ESCAPESEQUENCE;
IDENTIFIERREFERENCE -> IDENTIFIER;
BINDINGIDENTIFIER -> IDENTIFIER | YIELDS;
LABELIDENTIFIER -> IDENTIFIER | YIELDS;
IDENTIFIER -> IDENTIFIERSTART | IDENTIFIER IDENTIFIERPARTWITHOUTRESERVED;
PRIMARYEXPRESSION -> THIS | LITERAL | IDENTIFIERREFERENCE | SIMPLEEXPRESSION | ARRAYLITERAL | OBJECTLITERAL | FUNCTIONEXPRESSION | CLASSEXPRESSION | GENERATOREXPRESSION | TEMPLATELITERAL | COVERPARENTHESIZEDEXPRESSIONANDARROWPARAMETERLIST;
COVERPARENTHESIZEDEXPRESSIONANDARROWPARAMETERLIST -> NBO EXPRESSION NBC | NBO NBC | NBO DOTS DOTS DOTS BINDINGIDENTIFIER NBC | NBO EXPRESSION COMMA DOTS DOTS DOTS BINDINGIDENTIFIER NBC;
LITERAL -> NULLLITERAL | BOOLEANLITERAL | NUMERICLITERAL | STRINGLITERAL;
ARRAYLITERAL -> SBO SBC | SBO ELISION SBC | SBO ELEMENTLIST SBC | SBO ELEMENTLIST COMMA SBC | SBO ELEMENTLIST COMMA ELISION SBC;
ELEMENTLIST -> ELISION ASSIGNMENTEXPRESSION | ASSIGNMENTEXPRESSION | ELISION | ELISION SPREADELEMENT | SPREADELEMENT | ELEMENTLIST COMMA ELISION ASSIGNMENTEXPRESSION | ELEMENTLIST COMMA ASSIGNMENTEXPRESSION | ELEMENTLIST COMMA ELISION SPREADELEMENT | ELEMENTLIST COMMA SPREADELEMENT;
ELISION -> COMMA | ELISION COMMA;
SPREADELEMENT -> DOTS DOTS DOTS ASSIGNMENTEXPRESSION;
OBJECTLITERAL -> CBO CBC | CBO PROPERTYDEFINITIONLIST CBC;
PROPERTYDEFINITIONLIST -> PROPERTYDEFINITION | PROPERTYDEFINITIONLIST COMMA PROPERTYDEFINITION;
PROPERTYDEFINITION -> IDENTIFIERREFERENCE | COVERINITIALIZEDNAME | PROPERTYNAME COLON ASSIGNMENTEXPRESSION | METHODDEFINITION;
PROPERTYNAME -> LITERALPROPERTYNAME | COMPUTEDPROPERTYNAME;
LITERALPROPERTYNAME -> IDENTIFIERNAME | STRINGLITERAL | NUMERICLITERAL;
COMPUTEDPROPERTYNAME -> SBO ASSIGNMENTEXPRESSION SBC;
COVERINITIALIZEDNAME -> IDENTIFIERREFERENCE INITIALIZER;
INITIALIZER -> EQUAL ASSIGNMENTEXPRESSION;
TEMPLATELITERAL -> NOSUBSTITUTIONTEMPLATE | TEMPLATEHEAD EXPRESSION TEMPLATESPANS;
TEMPLATESPANS -> TEMPLATETAIL | TEMPLATEMIDDLELIST TEMPLATETAIL;
TEMPLATEMIDDLELIST -> TEMPLATEMIDDLE EXPRESSION | TEMPLATEMIDDLELIST TEMPLATEMIDDLE EXPRESSION;
MEMBEREXPRESSION -> PRIMARYEXPRESSION | MEMBEREXPRESSION SBO EXPRESSION SBC | MEMBEREXPRESSION DOTS IDENTIFIERNAME | MEMBEREXPRESSION TEMPLATELITERAL | SUPERPROPERTY | METAPROPERTY | NEWS MEMBEREXPRESSION ARGUMENTS;
SUPERPROPERTY -> SUPERS SBO EXPRESSION SBC | SUPERS DOTS IDENTIFIERNAME;
METAPROPERTY -> NEWTARGET;
NEWTARGET -> NEWS DOTS TARGETS;
NEWEXPRESSION -> MEMBEREXPRESSION | NEWS NEWEXPRESSION;
CALLEXPRESSION -> MEMBEREXPRESSION ARGUMENTS | SUPERCALL | CALLEXPRESSION ARGUMENTS | CALLEXPRESSION SBO EXPRESSION SBC | CALLEXPRESSION DOTS IDENTIFIERNAME | CALLEXPRESSION TEMPLATELITERAL;
SUPERCALL -> SUPERS ARGUMENTS;
ARGUMENTS -> NBO ARGUMENTLIST NBC | NBO NBC;
ARGUMENTLIST -> ASSIGNMENTEXPRESSION | DOTS DOTS DOTS ASSIGNMENTEXPRESSION | ARGUMENTLIST COMMA ASSIGNMENTEXPRESSION | ARGUMENTLIST COMMA DOTS DOTS DOTS ASSIGNMENTEXPRESSION;
LEFTSIDEEXPRESSION -> CALLEXPRESSION | NEWEXPRESSION;
POSTFIXEXPRESSION -> LEFTSIDEEXPRESSION | LEFTSIDEEXPRESSION INCR | LEFTSIDEEXPRESSION DECR;
UNARYEXPRESSION -> POSTFIXEXPRESSION | DELETES LEFTSIDEEXPRESSION | VOIDS UNARYEXPRESSION | TYPEOFS UNARYEXPRESSION | INCRS LEFTSIDEEXPRESSION | DECRS LEFTSIDEEXPRESSION | PLUS UNARYEXPRESSION | MIN UNARYEXPRESSION | WAVE UNARYEXPRESSION | SERU UNARYEXPRESSION;
MULTIPLICATIVEEXPRESSION -> UNARYEXPRESSION | MULTIPLICATIVEEXPRESSION MUL UNARYEXPRESSION | MULTIPLICATIVEEXPRESSION DIVIDE UNARYEXPRESSION | MULTIPLICATIVEEXPRESSION PERSEN UNARYEXPRESSION;
ADDITIVEEXPRESSION -> MULTIPLICATIVEEXPRESSION | ADDITIVEEXPRESSION PLUS MULTIPLICATIVEEXPRESSION | ADDITIVEEXPRESSION MIN MULTIPLICATIVEEXPRESSION;
SHIFTEXPRESSION -> ADDITIVEEXPRESSION | SHIFTEXPRESSION LESS LESS ADDITIVEEXPRESSION | SHIFTEXPRESSION GREAT GREAT ADDITIVEEXPRESSION | SHIFTEXPRESSION GREAT GREAT GREAT ADDITIVEEXPRESSION;
RELATIONALEXPRESSION -> SHIFTEXPRESSION | RELATIONALEXPRESSION LESS SHIFTEXPRESSION | RELATIONALEXPRESSION GREAT SHIFTEXPRESSION | RELATIONALEXPRESSION LESS EQUAL SHIFTEXPRESSION | RELATIONALEXPRESSION GREAT EQUAL SHIFTEXPRESSION | RELATIONALEXPRESSION INSTANCEOFS RELATIONALEXPRESSION | RELATIONALEXPRESSION INS RELATIONALEXPRESSION;
EQUALITYEXPRESSION -> RELATIONALEXPRESSION | EQUALITYEXPRESSION EQUAL EQUAL RELATIONALEXPRESSION | EQUALITYEXPRESSION SERU EQUAL RELATIONALEXPRESSION | EQUALITYEXPRESSION EQUAL EQUAL EQUAL RELATIONALEXPRESSION | EQUALITYEXPRESSION SERU EQUAL EQUAL RELATIONALEXPRESSION;
BITWISEANDEXPRESSION -> EQUALITYEXPRESSION | BITWISEANDEXPRESSION ANDS EQUALITYEXPRESSION;
BITWISEXOREXPRESSION -> BITWISEANDEXPRESSION | BITWISEXOREXPRESSION XORS BITWISEANDEXPRESSION;
BITWISEOREXPRESSION -> BITWISEXOREXPRESSION | BITWISEOREXPRESSION ORS BITWISEXOREXPRESSION;
LOGICALANDEXPRESSION -> BITWISEOREXPRESSION | LOGICALANDEXPRESSION ANDS ANDS BITWISEOREXPRESSION;
LOGICALOREXPRESSION -> LOGICALANDEXPRESSION | LOGICALOREXPRESSION ORS ORS LOGICALANDEXPRESSION;
CONDITIONALEXPRESSION -> LOGICALOREXPRESSION | LOGICALOREXPRESSION QUEST ASSIGNMENTEXPRESSION COLON;
ASSIGNMENTEXPRESSION -> CONDITIONALEXPRESSION | YIELDEXPRESSION | ARROWFUNCTION | LEFTSIDEEXPRESSION EQUAL ASSIGNMENTEXPRESSION | LEFTSIDEEXPRESSION ASSIGNMENTOPERATOR ASSIGNMENTEXPRESSION;
ASSIGNMENTOPERATOR -> MUL EQUAL | DIVIDE EQUAL | PERSEN EQUAL | PLUS EQUAL | MIN EQUAL | LESS LESS EQUAL | GREAT GREAT EQUAL | GREAT GREAT GREAT EQUAL | ANDS EQUAL | XORS EQUAL | ORS EQUALL;
EXPRESSION -> ASSIGNMENTEXPRESSION | EXPRESSION COMMA ASSIGNMENTEXPRESSION;
STATEMENT -> BLOCKSTATEMENTS | VARIABLESTATEMENT OPTIONALSEMICOLON | EMPTYSTATEMENT | EXPRESSIONSTATEMENT OPTIONALSEMICOLON | IFSTATEMENT | BREAKABLESTATEMENT | CONTINUESTATEMENT OPTIONALSEMICOLON | BREAKSTATEMENT OPTIONALSEMICOLON | RETURNSTATEMENT OPTIONALSEMICOLON | WITHSTATEMENT | LABELEDSTATEMENT | THROWSTATEMENT OPTIONALSEMICOLON | TRYSTATEMENT | SWITCHSTATEMENT | DOSTATEMENT OPTIONALSEMICOLON | WHILESTATEMENT | FORSTATEMENT;
DECLARATION -> HOISTABLEDECLARATION | CLASSDECLARATION | LEXICALDECLARATION;
HOISTABLEDECLARATION -> FUNCTIONDECLARATION | GENERATORDECLARATION;
BREAKABLESTATEMENT -> ITERATIONSTATEMENT | SWITCHSTATEMENT;
BLOCKSTATEMENT -> BLOCK;
BLOCK -> CBO STATEMENTLIST CBC;
STATEMENTLIST -> STATEMENTLISTITEM | STATEMENTLIST STATEMENTLISTITEM;
STATEMENTLISTITEM -> STATEMENT | DECLARATION;
LEXICALDECLARATION -> LETORCONST BINDINGLIST SEMICOLON;
LETORCONST -> LETS | CONSTS;
BINDINGLIST -> LEXICALBINDING | BINDINGLIST COMMA LEXICALBINDING;
LEXICALBINDING -> BINDINGIDENTIFIER | BINDINGIDENTIFIER INITIALIZER | BINDINGPATTERN INITIALIZER;
VARIABLESTATEMENT -> VARS VARIABLEDEFINITIONLIST;
VARIABLEDECLARATIONLIST -> VARIABLEDECLARATION | VARIABLEDECLARATIONLIST COMMA VARIABLEDECLARATION;
VARIABLEDECLARATION -> BINDINGIDENTIFIER | BINDINGIDENTIFIER INITIALIZER | BINDINGPATTERN INITIALIZER;
BINDINGPATTERN -> OBJECTBINDINGPATTERN | ARRAYBINDINGPATTERN;
OBJECTBINDINGPATTERN -> CBO BINDINGPROPERTYLIST CBC | CBO BINDINGPROPERTYLIST COMMA CBC | CBO BINDINGPROPERTYLIST COMMA CBC;
ARRAYBINDINGPATTERN -> SBO SBC | SBO ELISION SBC | SBO BINDINGRESTELEMENT SBC | SBO ELISION BINDINGRESTELEMENT SBC | SBO BINDINGELEMENTLIST SBC | SBO BINDINGELEMENTLIST COMMA SBC | SBO BINDINGELEMENTLIST COMMA BINDINGRESTELEMENT SBC | SBO BINDINGELEMENTLIST COMMA ELISION BINDINGRESTELEMENT SBC | SBO BINDINGELEMENTLIST COMMA ELISION SBC;
BINDINGPROPERTYLIST -> BINDINGPROPERTY | BINDINGPROPERTYLIST COMMA BINDINGPROPERTY;
BINDINGELEMENTLIST -> BINDINGELISIONELEMENT | BINDINGELEMENTLIST COMMA BINDINGELISIONELEMENT;
BINDINGELISIONELEMENT -> ELISION BINDINGELEMENT | BINDINGELEMENT;
BINDINGPROPERTY -> SINGLENAMEBINDING | PROPERTYNAME COLON BINDINGELEMENT | COLON BINDINGELEMENT;
BINDINGELEMENT -> SINGLENAMEBINDING | BINDINGPATTERN INITIALIZER;
SINGLENAMEBINDING -> BINDINGIDENTIFIER INITIALIZER ;
BINDINGRESTELEMENT -> DOTS DOTS DOTS BINDINGIDENTIFIER;
EMPTYSTATEMENT -> SEMICOLON;
EXPRESSIONSTATEMENT -> EXPRESSION;
IFSTATEMENT -> IF PARENTHESIZEDEXPRESSION STATEMENT | IF PARENTHESIZEDEXPRESSION STATEMENT ELSE STATEMENT;
ITERATIONSTATEMENT -> DOS  STATEMENT WHILES NBO EXPRESSION NBC SEMICOLON | WHILES NBO EXPRESSION NBC STATEMENT | FORSTATEMENTA | FORSTATEMENTVAR | FORSTATEMENTLEX | FORSTATEMENTIN | FORSTATEMENTVARIN | FORSTATEMENTFOR | FORSTATEMENTOF | FORSTATEMENTVAR | FORSTATEMENTFVAROF | FORSTATEMENTDEC; 
FORSTATEMENTA -> FORS NBO EXPRESSION SEMICOLON EXPRESSION SEMICOLON EXPRESSION NBC STATEMENT | FORS NBO SEMICOLON SEMICOLON NBC STATEMENT | FORS NBO SEMICOLON EXPRESSION SEMICOLON NBC STATEMENT | FORS NBO SEMICOLON SEMICOLON EXPRESSION NBC STATEMENT | FORS NBO SEMICOLON EXPRESSION SEMICOLON EXPRESSION NBC STATEMENT | FORS NBO EXPRESSION SEMICOLON SEMICOLON NBC STATEMENT |  FORS NBO EXPRESSION SEMICOLON SEMICOLON EXPRESSION NBC STATEMENT | FORS NBO EXPRESSION SEMICOLON EXPRESSION SEMICOLON NBC STATEMENT;
FORSTATEMENTVAR -> FORS NBO VARS VARIABLEDECLARATIONLIST EXPRESSION SEMICOLON EXPRESSION SEMICOLON EXPRESSION NBC STATEMENT | FORS NBO VARS VARIABLEDECLARATIONLIST SEMICOLON SEMICOLON NBC STATEMENT | FORS NBO VARS VARIABLEDECLARATIONLIST SEMICOLON EXPRESSION SEMICOLON NBC STATEMENT | FORS NBO VARS VARIABLEDECLARATIONLIST SEMICOLON SEMICOLON EXPRESSION NBC STATEMENT | FORS NBO VARS VARIABLEDECLARATIONLIST SEMICOLON EXPRESSION SEMICOLON EXPRESSION NBC STATEMENT | FORS NBO VARS VARIABLEDECLARATIONLIST EXPRESSION SEMICOLON SEMICOLON NBC STATEMENT |  FORS NBO VARS VARIABLEDECLARATIONLIST EXPRESSION SEMICOLON SEMICOLON EXPRESSION NBC STATEMENT | FORS NBO VARS VARIABLEDECLARATIONLIST EXPRESSION SEMICOLON EXPRESSION SEMICOLON NBC STATEMENT; 
FORSTATEMENTLEX -> FORS NBO LEXICALDECLARATION EXPRESSION SEMICOLON EXPRESSION SEMICOLON EXPRESSION NBC STATEMENT | FORS NBO LEXICALDECLARATION SEMICOLON SEMICOLON NBC STATEMENT | FORS NBO LEXICALDECLARATION SEMICOLON EXPRESSION SEMICOLON NBC STATEMENT | FORS NBO LEXICALDECLARATION SEMICOLON SEMICOLON EXPRESSION NBC STATEMENT | FORS NBO LEXICALDECLARATION SEMICOLON EXPRESSION SEMICOLON EXPRESSION NBC STATEMENT | FORS NBO LEXICALDECLARATION EXPRESSION SEMICOLON SEMICOLON NBC STATEMENT |  FORS NBO LEXICALDECLARATION EXPRESSION SEMICOLON SEMICOLON EXPRESSION NBC STATEMENT | FORS NBO LEXICALDECLARATION EXPRESSION SEMICOLON EXPRESSION SEMICOLON NBC STATEMENT;
FORSTATEMENTIN -> FORS NBO LEFTSIDEEXPRESSION INS EXPRESSION NBC STATEMENT;
FORSTATEMENTVARIN -> FORS NBO VARS FORBINDING INS EXPRESSION NBC STATEMENT;
FORSTATEMENTFOR -> FORS NBO FORDECLARATION INS EXPRESSION NBC STATEMENT;
FORSTATEMENTOF -> FORS NBO LEFTSIDEEXPRESSION OFS ASSIGNMENTEXPRESSION NBC STATEMENT;
FORSTATEMENTVAROF -> FORS NBO VARS FORBINDING OFS ASSIGNMENTEXPRESSION NBC STATEMENT;
FORSTATEMENTDEC -> FORS NBO FORDECLARATION OFS ASSIGNMENTEXPRESSION NBC STATEMENT;
FORDECLARATION -> LETORCONST FORBINDING;
FORBINDING -> BINDINGIDENTIFIER | BINDINGPATTERN;
CONTINUESTATEMENT -> CONTINUES SEMICOLON | CONTINUES LABELIDENTIFIER SEMICOLON;
BREAKSTATEMENT -> BREAKS SEMICOLON | BREAKS LABELIDENTIFIER SEMICOLON;
RETURNSTATEMENT -> RETURNS SEMICOLON | RETURNS EXPRESSION SEMICOLON;
WITHSTATEMENT -> WITHS PARENTHESIZEDEXPRESSION STATEMENT;
SWITCHSTATEMENT -> SWITCH PARENTHESIZEDEXPRESSION CASEBLOCK;
CASEBLOCK -> CBO CBC | CBO CASECLAUSES CBC | CBO DEFAULTCLAUSE CBC | CBO CASECLAUSES DEFAULTCLAUSE CBC | CBO DEFAULTCLAUSE CASECLAUSES CBC | CBO CASECLAUSES DEFAULTCLAUSE CASECLAUSES CBC;
CASECLAUSES -> CASECLAUSE | CASECLAUSES CASECLAUSE;
CASECLAUSE -> CASES EXPRESSION COLON STATEMENTLIST | CASES EXPRESSION COLON;
DEFAULTCLAUSE -> DEFAULTS COLON STATEMENTLIST | DEFAULTS COLON;
LABELEDSTATEMENT -> LABELIDENTIFIER COLON LABELLEDITEM;
LABELLEDITEM -> STATEMENT | FUNCTIONDECLARATION;
THROWSTATEMENT -> THROWS EXPRESSION SEMICOLON;
TRYSTATEMENT -> TRYS BLOCK CATCH | TRYS BLOCK FINALLY | TRYS BLOCK CATCH FINALLY;
CATCH -> CATCHS NBO CATCHPARAMETER NBC BLOCK;
FINALLY -> FINALLYS BLOCK;
CATCHPARAMETER -> BINDINGIDENTIFIER | BINDINGPATTERN;
FUNCTIONDECLARATION -> FUNCTIONS BINDINGIDENTIFIER NBO FORMALPARAMETERS NBC CBO FUNCTIONBODY CBC;
FUNCTIONEXPRESSION -> FUNCTIONS BINDINGIDENTIFIER NBO FORMALPARAMETERS NBC CBO FUNCTIONBODY CBC | FUNCTIONS NBO FORMALPARAMETERS NBC CBO FUNCTIONBODY CBC | FUNCTIONS NBO FORMALPARAMETERS NBC CBO FUNCTIONBODY CBC;
STRICTFORMALPARAMETERS -> FORMALPARAMETERS;
FORMALPARAMETERS -> FORMALPARAMETERLIST | ;
FORMALPARAMETERLIST -> FUNCTIONRESTPARAMETER | FORMALSLIST | FORMALSLIST COMMA FUNCTIONRESTPARAMETER;
FORMALSLIST -> FORMALPARAMETER | FORMALSLIST COMMA FORMALPARAMETER;
FUNCTIONRESTPARAMETER -> BINDINGRESTELEMENT;
FORMALPARAMETER -> BINDINGELEMENT;
FUNCTIONBODY -> FUNCTIONSTATEMENTLIST;
FUNCTIONSTATEMENTLIST -> STATEMENTLIST | ;
ARROWFUNCTION -> ARROWPARAMETERS EQUAL GREAT CONCISEBODY;
ARROWPARAMETERS -> BINDINGIDENTIFIER | COVERPARENTHESIZEDEXPRESSIONANDARROWPARAMETERLIST;
CONCISEBODY -> ASSIGNMENTEXPRESSION | CBO FUNCTIONBODY CBC;
METHODDEFINITION -> PROPERTYNAME NBO STRICTFORMALPARAMETERS NBC CBO FUNCTIONBODY CBC | GENERATORMETHOD | GETS PROPERTYNAME NBO NBC CBO FUNCTIONBODY CBC | SETS PROPERTYNAME NBO PROPERTYSETPARAMETERLIST NBC CBO FUNCTIONBODY CBC;
PROPERTYSETPARAMETERLIST -> FORMALPARAMETER;
GENERATORMETHOD -> MUL PROPERTYNAME NBO STRICTFORMALPARAMETERS NBC CBO GENERATORBODY CBC;
GENERATORDECLARATION -> FUNCTIONS MUL BINDINGIDENTIFIER NBO FORMALPARAMETERS NBC SBO GENERATORBODY SBC;
GENERATOREXPRESSION -> FUNCTIONS MUL BINDINGIDENTIFIER NBO FORMALPARAMETERS NBC SBO GENERATORBODY SBC;
GENERATORBODY -> FUNCTIONBODY;
YIELDEXPRESSION -> YIELDS ASSIGNMENTEXPRESSION | YIELDS | YIELDS MUL ASSIGNMENTEXPRESSION;
CLASSDECLARATION -> CLASSS BINDINGIDENTIFIER CLASSTAIL | CLASSS CLASSTAIL;
CLASSEXPRESSION -> CLASSS BINDINGIDENTIFIER CLASSTAIL;
CLASSTAIL -> CLASSHERITAGE CBO CLASSBODY CBC | CBO CLASSBODY CBC;
CLASSHERITAGE -> EXTENDSS LEFTSIDEEXPRESSION;
CLASSBODY -> CLASSELEMENTLIST;
CLASSELEMENTLIST -> CLASSELEMENT | CLASSELEMENTLIST CLASSELEMENT;
CLASSELEMENT -> METHODDEFINITION | STATICS METHODDEFINITION | SEMICOLON;
SCRIPT -> SCRIPTBODY | ;
SCRIPTBODY -> STATEMENTLIST;
MODULE -> MODULEBODY | ;
MODULEBODY -> MODULEITEMLIST;
MODULEITEMLIST -> MODULEITEM | MODULEITEMLIST MODULEITEM;
MODULEITEM -> IMPORTDECLARATION | EXPORTDECLARATION | STATEMENTLISTITEM;
IMPORTDECLARATION -> IMPORTS IMPORTCLAUSE FROMCLAUSE SEMICOLON | IMPORTS MODULESPECIFIER;
IMPORTCLAUSE -> IMPORTEDDEFAULTBINDING | NAMESPACEIMPORT | NAMEDIMPORTS | IMPORTEDDEFAULTBINDING COMMA NAMESPACEIMPORT | IMPORTEDDEFAULTBINDING COMMA NAMEDIMPORTS;
IMPORTEDDEFAULTBINDING -> IMPORTEDBINDING;
NAMESPACEIMPORT -> MUL ASS IMPORTEDBINDING;
NAMEDIMPORTS -> CBO  CBC | CBO IMPORTSLIST CBC | CBO IMPORTSLIST COMMA CBC;
FROMCLAUSE -> FROMS MODULESPECIFIER;
IMPORTSLIST -> IMPORTSPECIFIER | IMPORTSLIST COMMA IMPORTSPECIFIER;
IMPORTSPECIFIER -> IMPORTEDBINDING | IDENTIFIERNAME ASS IMPORTEDBINDING;
MODULESPECIFIER -> STRINGLITERAL;
IMPORTEDBINDING -> BINDINGIDENTIFIER;
EXPORTDECLARATION -> EXPORTS MUL FROMCLAUSE SEMICOLON | EXPORTS EXPORTCLAUSE FROMCLAUSE SEMICOLON | EXPORTS EXPORTCLAUSE SEMICOLON | EXPORTS VARIABLESTATEMENT | EXPORTS DECLARATION | EXPORTS DEFAULTS HOISTABLEDECLARATION | EXPORTS DEFAULTS CLASSDECLARATION | EXPORTS DEFAULTS ASSIGNMENTEXPRESSION;
EXPORTCLAUSE -> CBO CBC | CBO EXPORTSLIST CBC | CBO EXPORTSLIST COMMA CBC;
EXPORTSLIST -> EXPORTPECIFIER | EXPORTSLIST COMMA EXPORTPECIFIER;
EXPORTPECIFIER -> IDENTIFIERNAME | IDENTIFIERNAME ASS IDENTIFIERNAME;

ATS -> @;
ZERO -> 0;
DOTS -> .;
XORS -> ^;
ANDS -> &;
ORS -> |;
SERU -> !;
QUEST -> ?;
HASHTAG -> #;
DOLLAR -> $;
PERSEN -> %;
NBO -> (;
NBC -> );
WAVE -> ~;
MUL -> *;
POW -> * *;
PLUS -> +;
INCR -> + +;
MIN -> -;
DECR -> - -; 
COMMA -> ,;
DIVIDE -> /;
DIV -> / /;
DIVBACK -> \;
COLON -> :;
LESS -> <;
EQUAL -> =;
GREAT -> >;
SBO -> [;
SBC -> ];
UNDERSCORE -> _;
CBO -> {;
CBC -> };
PETIK1 -> ';
PETIK2 -> ";
NONES -> none;
DELETES -> delete;
SWITCHS -> switch;
CASES -> case;
VOIDS -> void;
TYPEOFS -> typeof;
ANDS -> and;
TRYS -> try
ORS -> or;
ISS -> is;
INS -> in;
NOTS -> not;
TRUES -> true;
FALSES -> false;
FORS -> for;
DOS -> do;
WHILES -> while;
IFS -> if;
ELIFS -> else if;
ELSES -> else;
BREAKS -> break;
CONTINUES -> continue;
FINALLYS -> finally;
CATCHS -> catch;
FUNCTIONS -> function;
RETURNS -> return;
CLASSS -> class;
FROMS -> from;
IMPORTS -> import;
ASS -> as;
VAR -> var;
EXPORTS -> export;
EXTENDSS -> extends;
CONSTS -> const;
SUPERS -> super;
WITHS -> with;
YIELDS -> yield;
DEFAULTS -> default;
THROWS -> throw;
STATICS -> static;
TARGETS -> target;
NEWS -> new;
THISS -> this;
NULLS -> null;
INSTANCEOFS -> instanceof;
SEMICOLON -> ;

